{"name": "level8",
  "moves": 5,
  "level": [
  [0, 0, 0, 0, 0, 0],
  [0, 0, 0, 0, 0, 0],
  [0, 0, 0, 0, 0, 0],
  [0, 0, 0, 0, 0, 0],
  [0, 0, 0, 0, 0, 0],
  [0, 0, 0, 0, 0, 0],
  [0, 0, 0, 0, 0, 0],
  [0, 0, 0, 0, 0, 0],
  [0, 0, 0, 0, 0, 0],
  [0, 0, 0, 0, 0, 0],
  [0, 0, 0, 0, 0, 0],
  [3, 3, 2, 2, 3, 3],
  [1, 4, 6, 5, 4, 1],
  [1, 6, 4, 4, 5, 1],
  [2, 6, 2, 2, 5, 2],
  [1, 3, 4, 4, 3, 1]
]}