{"name": "level9",
  "moves": 4,
  "level": [
  [0, 0, 0, 0, 0, 0],
  [0, 0, 0, 0, 0, 0],
  [0, 0, 0, 0, 0, 0],
  [0, 0, 0, 0, 0, 0],
  [0, 0, 0, 0, 0, 0],
  [0, 0, 0, 0, 0, 0],
  [0, 0, 1, 0, 0, 0],
  [0, 0, 6, 0, 5, 0],
  [0, 0, 2, 0, 6, 0],
  [0, 0, 3, 0, 2, 0],
  [0, 0, 3, 5, 3, 0],
  [0, 0, 6, 1, 6, 0],
  [0, 0, 2, 6, 5, 0],
  [0, 0, 3, 6, 3, 0],
  [0, 0, 2, 3, 2, 0],
  [0, 0, 1, 2, 3, 0]
]}