{"name": "level1",
  "moves": 1,
  "level": [
  [0, 0, 0, 0, 0, 0],
  [0, 0, 0, 0, 0, 0],
  [0, 0, 0, 0, 0, 0],
  [0, 0, 0, 0, 0, 0],
  [0, 0, 0, 0, 0, 0],
  [0, 0, 0, 0, 0, 0],
  [0, 0, 0, 0, 0, 0],
  [0, 0, 0, 0, 0, 0],
  [0, 0, 0, 0, 0, 0],
  [0, 0, 0, 0, 0, 0],
  [0, 0, 0, 0, 0, 0],
  [0, 0, 1, 0, 0, 0],
  [0, 0, 2, 0, 0, 0],
  [0, 0, 2, 0, 0, 0],
  [0, 0, 1, 0, 0, 0],
  [0, 0, 2, 1, 1, 0]
]}