{"name": "level6",
  "moves": 4,
  "level": [
    [0, 0, 0, 0, 0, 0],
    [0, 0, 0, 0, 0, 0],
    [0, 0, 0, 0, 0, 0],
    [0, 0, 0, 0, 0, 0],
    [0, 0, 0, 0, 0, 0],
    [0, 0, 0, 0, 0, 0],
    [0, 0, 0, 0, 0, 0],
    [0, 0, 0, 0, 0, 0],
    [0, 0, 0, 0, 0, 0],
    [0, 0, 0, 0, 0, 0],
    [0, 6, 2, 0, 0, 0],
    [0, 5, 3, 0, 0, 0],
    [0, 5, 5, 0, 0, 0],
    [0, 3, 3, 0, 0, 0],
    [0, 6, 2, 0, 0, 0],
    [0, 5, 6, 6, 2, 0]
  ]}